####################
##  # # # #   #  # #
# # #      # # # # #
#    ##P## #   # # #
## #  # # # # #  # #
# ## #   P#     # P#
#   P ## ## # #   ##
## ## #    ### ##  #
#  ##S## # ##   # ##
# #      ##   ##   #
#  # ## # # #  P# ##
###P#      # ## #  #
#    # # #        ##
## # T  #P #### #  #
#   # ## P#    # # #
# #####  #  # ##   #
### # P # #E#   ## #
#     #T#  #  #  # #
## # #    ###  #   #
####################
